Mm, Mm, Hh, Hh^Fds, Gs^Fms, Hh^Fds, Hh, Hh, Gs, Hh, Hh, Gs, Gs^Fms, Ww^Qhu, Gg, Gs^Fms, Gs^Fms, Hh^Fds, Gg, Hh^Fds, Mm, Mm
Mm, Mm, Hh, Hh, Gs^Fdw, Hh, Hhd, Hhd, Rb^Vo, Hhd, Hhd, Gs^Es, Gs^Fdw, Ww^Qhu, Gg, Gs^Fds, Gs^Fms, Hh, Gs^Vc, Hh, Mm, Mm
Hh, Hh, Gs^Fms, Gs^Fetd, Rb^Vo, Gs^Ecf, Gs^Es, Hhd, Re^Es, Rb, Re, Gs^Fdw, Re, Ww^Qhu, Ww^Qhu, Gg, Gs^Fds, Gs^Fms, Gg, Hh, Hh, Hh
Hh, Hh, Hh, Gs^Fms, Gs, Rb, Co, Rb, Rb, Hhd, Hh, Re^Es, Hh, Gs, Gs, Ww^Qhu, Gs, Gs, Gs^Fds, Gg, Hh, Hh^Fds
Mm, Hh, Gs^Dr, Gs^Fdw, Re, Co, 2 Ko, Co^Es, Re, Gs^Fdw, Hh, Hh, Hh^Fds, Cer, Gs^Fds, Ww^Qhu, Gs, Gs, Gs^Fds, Gg, Gs^Fms, Gs^Fms
Hh, Hh, Gs^Fds, Gs^Es, Gs^Es, Co, Co, Co, Gs^Es, Gs^Es, Hh, Hh, Hh, Gs^Fms, Ww^Qhu, Ww^Qhu, Gs^Fms, Gs, Gg, Gg, Gs^Fds, Gs^Fms
Hh, Hh, Gs^Dr, Gs, Rb, Rb, Re, Rb^Es, Gs^Edb, Gs^Dr, Gs^Dr, Hh, Gs^Feth, Gs^Fms, Ww^Qhu, Gs^Fds, Hh, Gs^Fds, Gg, Gs^Fms, Gs^Fms, Gs^Fms
Hh^Fds, Hh, Gs^Fdw, Gs^Edb, Rb^Es, Gs^Fdw, Gs^Fdw, Rb, Rb, Gs^Fms, Gs, Gs, Ww^Qhu, Ww^Qhu, Hh, Hh, Hh^Fds, Gs^Fms, Gs^Fds, Gg, Gs^Fds, Gs^Fds
Gs^Fms, Gs^Fms, Ww^Qhu, Gs, Rb, Gs^Es, Gd^Vo, Gs^Fdw, Hh, Rb, Rb, Gs^Ecf, Ww^Qhu, Gs^Fms, Gs^Fms, Gs^Fds, Gs^Fms, Gg^Ve, Gg, Gg, Gs^Fms, Gs^Fms
Ww^Qhu, Ww^Qhu, Gs, Wwf^Qhu, Ww^Qhu, Gs, Gs^Fdw, Hh, Hh, Hh, Rb, Gs^Fds, Ww^Qhu, Gs^Fds, Ww^Qhu, Ww^Qhu, Ww^Qhu, Gs^Fms, Gg, Gs^Fds, Ww^Qhu, Ww^Qhu
Gs^Fds, Gs^Fms, Gs^Fms, Re, Gs^Fms, Ww^Qhu, Ww^Qhu, Gs^Fds, Gs^Fms, Gs^Fdw, Ww^Qhu, Ww^Qhu, Ww^Qhu, Ww^Qhu, Gs^Fds, Gs^Fds, Gs^Fms, Ww^Qhu, Ww^Qhu, Ww^Qhu, Gs^Fms, Gs^Fds
Gs^Fds, Gs^Fds, Gs^Fms, Rb, Hh^Fds, Gs^Fds, Ww^Qhu, Gs^Fms, Ww^Qhu, Ww^Qhu, Gs^Fds, Gg, Gs^Fms, Gs^Fds, Hh, Hh, Gs^Fds, Gs^Fms, Gg, Gs^Fds, Gs^Fds, Gs^Fds
Gs^Fds, Gs^Fds, Gs^Fds, Rb, Re, Gs^Fms, Gs^Fds, Ww^Qhu, Gs^Fds, Gs^Fds, Hh, Gg, Hh, Hh, Gs^Fds, Gs^Fms, Gg, Gg, Gs^Fms, Gg^Ve, Gs^Fds, Gs^Fds
Hh^Fds, Hh, Hh, Gs^Fms, Gg, Gs^Fms, Gs^Fms, Ww^Qhu, Gs^Fms, Gs^Fds, Gs^Fms, Gg, Gg, Gg, Gg^Efm, Gs^Fms, Gg, Gs^Fds, Gg^Fet, Gs^Fds, Ww, Ww
Mm, Mm, Hh, Gg^Vc, Hh, Gg^Efm, Gs^Fds, Ww^Qhu, Gs^Fds, Gg^Fet, Gg^Vc, Gs^Fds, Gs^Fms, Gs^Fds, Gs^Fds, Gg, Ww, Ww, Ww, Ww, Gs^Fds, Gs^Fds
Mm, Mm, Hh, Hh, Hh, Gg^Efm, Ww^Qhu, Ww^Qhu, Ww, Gg, Ww, Ww, Ww^Ewf, Gs^Fds, Ww, Ww, Gg^Efm, Gs^Fds, Gs^Fds, Gs^Fds, Gs^Fds, Gs^Fds
Hh, Hh, Gg, Hh, Gg, Gg, Ww^Qhu, Ww^Qhu, Gs^Fms, Ww, Gg, Gg, Gs^Fds, Ww, Gs^Fds, Gs^Fds, Gg, Gs^Fds, Gs^Fds, Gg^Fet, Gs^Fds, Gs^Fds
Hh, Hh, Ww^Qhu, Gs^Fds, Ww^Qhu, Ww^Qhu, Ww^Qhu, Ww^Qhu, Gs^Fms, Gs^Fms, Gg, Gs^Fds, Gg^Fet, Gs^Fds, Gs^Fds, Gg^Ve, Gs^Fds, Gg, Gs^Fds, Gs^Fds, Gg^Ve, Gg
Ww^Qhu, Ww^Qhu, Wo^Qhu, Ww^Qhu, Ww^Qhu, Ww^Qhu, Gg, Gg^Efm, Gs^Fds, Gs^Fds, Hh^Fds, Gg^Efm, Gs^Fds, Gs^Fds, Gg^Fet, Gs^Fds, Gs^Fds, Gg^Efm, Gg, Gg, Gg^Efm, Gg^Efm
Wo^Qhu, Wo^Qhu, Wo^Qhu, Wo^Qhu, Ww^Qhu, Gs^Fds, Gs^Fds, Gg^Vc, Gg, Hh^Fds, Hh^Fds, Gg, Gg, Gs^Fds, Gs^Fds, Gs^Fds, Ce, Ce, Ce, Gs^Fds, Gs^Fds, Gs^Fds
Wo^Qhu, Wo^Qhu, Wo^Qhu, Wo^Qhu, Ww^Qhu, Gg, Gs^Fds, Gs^Fds, Hh^Fds, Hh, Hh, Hh^Fds, Gg, Gs^Fds, Gs^Fds, Gs^Fds, Ce, 1 Ke, Ce, Gs^Fds, Gs^Fds, Gs^Fds
Wo^Qhu, Wo^Qhu, Wo^Qhu, Wo^Qhu, Ww^Qhu, Gg, Gs^Fds, Gs^Fds, Hh^Fds, Hh, Hh, Hh, Gg, Gs^Fds, Gs^Fds, Gs^Fds, Gs^Fds, Gs^Fds, Gs^Fds, Gs^Fds, Gs^Fds, Gs^Fds
