Mm, Mm, Mm, Hh, Hhd, Gd, Gd, Gd, Re, Re, Gd^Fmw, Re, Re, Gd, Gs, Hh, Hh, Mm, Hh, Mm, Mm, Mm
Mm, Mm, Mm, Hhd, Hhd, Gd, Gd, Gd, Re, Re, Gd^Fdw, Rb^Es, Re, Gd, Gs^Es, Hh, Hh, Mm, Hh, Mm, Mm, Mm
Mm, Hh, Hhd, Hhd, Hhd, Gd, Re, Re^Em, Re, Rb, Re, Re^Es, Re^Em, Gd, Gd^Es, Hhd, Hhd, Hh, Hhd, Hh, Mm, Mm
Hh, Hh, Hh, Hhd, Gd, Gd, Re, Rb^Em, Re^Es, Re, Ss, Ss, Cvr, Re^Em, Re, Gd, Gd, Gs, Gs^Es, Hhd, Hh, Hh
Hh, Hh, Hh, Gs, Gd, Gd, Re^Es, Re, Re^Es, Wwg, Ss^Es, Cvr, 2 Kvr, Cvr, Ss, Re^Es, Gd, Gs^Es, Hhd, Hh, Hh, Hh
Mm, Hh, Hh, Gs, Gd, Re, Re^Fdw, Rb, Re, Wwg, Wwg, Cvr, Cvr, Cvr, Wwg^Bw\, Re, Gs^Es, Hhd, Gs^Ecf, Hhd, Hhd, Hhd
Hh, Hh, Hh, Hhd, Gd, Re, Re, Re, Re, Re^Ebn, Re, Wwg^Bw/, Wwg, Wwg, Re, Gs^Es, Gd, Gs^Em, Gd, Gs, Gs, Hhd
Hhd, Hhd, Hhd, Hhd, Re, Rb, Re, Re^Fmw, Re, Re^Es, Re, Re^Es, Re, Re, Re, Re^Es, Re, Gd, Re^Fdw, Gd, Gd, Re
Hhd, Re, Re, Re^Edb, Re^Fmw, Re^Fmw, Re^Ecf, Re, Re, Re, Rb^Fdw, Re, Re, Re, Re, Re, Re, Re^Es, Rb^Fdw, Re^Fdw, Re, Re
Hhd, Re^Edb, Re, Rb^Fdw, Re, Re^Fdw, Re, Re, Re, Rb^Fdw, Re^Fdw, Re^Fdw, Re^Edb, Re, Re, Re^Fdw, Re, Re^Fdw, Re^Fdw, Rb^Fdw, Re, Ss
Re, Re, Gd^Fmw, Re, Re^Es, Re, Rb^Fmw, Re^Edb, Re, Rb^Fdw, Re^Fdw, Rb^Fdw, Rb, Re^Es, Re, Re, Re^Edb, Re, Re, Re, Re, Re
Gd, Re, Gd^Fmw, Gd, Gd, Gd^Fdw, Gd^Fdw, Re^Fmw, Re, Re, Re^Es, Re, Re^Fdw, Rb, Rb, Rb^Fdw, Rb^Fdw, Re^Ecf, Gd, Gd^Fdw, Gd, Gd
Gd, Gd, Gd, Gd, Gd, Gd^Fdw, Gs, Gd, Gd, Gd, Gd, Re^Fdw, Rb^Fdw, Re^Fdw, Re^Fdw, Re^Fdw, Re^Fdw, Re, Gd, Gd, Gd, Gd
Gs, Gd, Gs, Gd, Gs^Fmw, Gs^Fmw, Gs, Gs, Gs^Es, Gd, Gd, Gd^Fdw, Gd^Fdw, Gd^Fdw, Gd^Fdw, Rb^Fdw, Rb, Gd, Gs, Gs, Gs, Gs
Gg, Gs, Gs, Gd, Gs, Gs^Fmw, Gs^Fmw, Gs, Gs^Fmw, Gs^Fmw, Gs^Fmw, Gd, Gd, Gd, Gd, Gd, Gd, Gd, Gs^Fmw, Gs^Fmw, Gg^Fmw, Gg^Fms
Gg, Gg, Gs^Fmw, Gs^Fmw, Gs^Fmw, Gs, Gg, Gs, Gs^Fmw, Gs^Fmw, Gs^Fmw, Gd, Gd^Es, Gd, Gs^Fmw, Gs^Fmw, Gs^Fmw, Rb, Gg^Fms, Gg^Fms, Gs^Fms, Gg^Fms
Gg, Gg, Gs^Fmw, Gs^Fmw, Gs^Fmw, Gg, Gg, Gs^Fmw, Gs^Fmw, Gs^Fmw, Gg, Gs, Gs^Em, Gd, Gg^Fmw, Gg^Fmw, Gg^Fmw, Rb, Gg, Gs^Fms, Gs^Fms, Gs^Fms
Gg, Gg, Gs^Fmw, Gs^Fmw, Gs^Fmw, Gs^Fmw, Gs^Fmw, Gs^Fmw, Gs^Fms, Gs^Fmw, Gg^Em, Gs, Gg, Gs^Fms, Gs^Fms, Gs^Fms, Gg, Gg, Gg, Gs^Fms, Gs^Fms, Gs^Fms
Gs^Fmw, Gs^Fmw, Gs^Fmw, Gs^Fmw, Gs^Fp, Gs^Fp, Gs^Fmw, Gs, Gs, Gg, Gs^Fp, Gg, Gs^Fp, Gs^Fms, Gs^Fms, Gs^Fms, Gg, Gg, Gg, Gg, Gs^Fms, Gs^Fms
Gs^Fdw, Gs^Fp, Gs^Fp, Gs^Fp, Gs^Fdw, Gs^Fp, Gs^Fdw, Gg^Efm, Gg, Gs^Fms, Gs^Fms, Gg, Gg, Gg^Efm, Gs^Fms, Gs^Fms, Gs^Fms, Gg, Gs^Fms, Gs^Fms, Gs^Fms, Gs^Fms
Gs^Fms, Gs^Fms, Gs^Fdw, Gs^Fp, Gs^Fms, Gs^Fms, Gs^Fms, Gs^Fds, Gg, Gs^Fms, Gs^Fms, Gs^Fms, Gs^Fds, Gg^Em, Gs^Fms, Gs^Fms, Gs^Fms, Gs^Fms, Gs^Fms, Gs^Fms, 1 Gs^Fp, Gs^Fp
Gs^Fms, Gs^Fms, Gs^Fms, Gs^Fms, Gs^Fms, Gs^Fms, Gs^Fms, Gs^Fms, Gg, Gs^Fms, Gs^Fms, Gs^Fms, Gs^Fds, Gg, Gs^Fms, Gs^Fms, Gs^Fms, Gs^Fms, Gs^Fp, Gs^Fp, Gs^Fp, Gs^Fp
