Mm, Mm, Mm, Hh, Hhd, Gd, Gd, Gd, Re^Qhu, Re^Qhu, Gd^Qhuf, Re^Qhu, Re^Qhu, Gd^Qhu, Gs^Qhu, Hh, Hh, Mm, Hh, Mm, Mm, Mm
Mm, Mm, Mm, Hhd, Hhd, Gd, Gd^Qhu, Gd^Qhu, Re, Re, Gd^Fdw, Rb^Es, Re^Edb, Gd, Gs^Qhu, Hh, Hh, Mm, Hh, Mm, Mm, Mm
Mm, Hh, Hhd, Hhd, Hhd, Gd, Re^Qhu, Re^Em, Re^Edb, Rb, Re, Re^Es, Re^Em, Gd, Gd^Qhu, Hhd, Hhd, Hh, Hhd, Hh, Mm, Mm
Hh, Hh, Hh, Hhd, Gd, Gd^Qhu, Re, Rb^_mll, Re^Es, Re^Edb, Ss, Ss, Cvr, Re^Edt, Re, Gd^Qhu, Gd^Qhu, Gs, Gs^Es, Hhd, Hh, Hh
Hh, Hh, Hh, Gs, Gd, Gd^Qhu, Re^Qhu, Re, Re^Es, Wwg, Ss^Es, Cvr, 2 Kvr, Cvr, Ss, Re^Es, Gd^Qhu, Gs^Edb, Hhd, Hh, Hh, Hh
Mm, Hh, Hh, Gs, Gd, Re^Edb, Re^Fdw, Rb^Qhu, Re, Wwg, Wwg, Cvr, Cvr, Cvr, Wwg^Bw\, Re, Gs^Qhu, Hhd, Gs^Ecf, Hhd, Hhd, Hhd
Hh, Hh, Hh, Hhd, Gd, Re, Re, Re^Qhu, Re^Qhu, Re^Ebn, Re, Wwg^Bw/, Wwg, Wwg, Re, Gs^Es, Gd^Qhu, Gs^Em, Gd, Gs, Gs, Hhd
Hhd, Hhd, Hhd, Hhd, Re, Rb^Edt, Re, Re^Fmw, Re, Re^Qhu, Re^Qhu, Re^Es, Re^Edb, Re, Re^Qhu, Re^Qhu, Re^Edb, Gd, Re^Fdw, Gd, Gd, Re
Hhd, Re, Re, Re^Edb, Re, Re^Fmw, Re^Ecf, Re, Re^Edt, Re, Rb^Fdw, Re^Qhu, Re^Qhu, Re^Qhu, Re, Re^Edb, Re, Re^Es, Rb^Fdw, Re^Fdw, Re, Re
Hhd, Re^Edb, Re, Rb^Fdw, Re, Re^Fdw, Re, Re, Re, Rb^Fdw, Re^Fdw, Re, Re^Edb, Re, Re, Re, Re, Re^Fdw, Re^Fdw, Re, Re^Edt, Ss
Re, Re^Edt, Gd^Fmw, Re, Re^Es, Re, Rb^Fmw, Re^Edb, Re, Rb^Fdw, Re, Rb^Fdw, Rb, Re^Es, Re, Re^Edb, Re^Edb, Re, Re^Edb, Re, Re, Re
Gd, Re, Gd^Fmw, Gd, Gd, Gd^Fdw, Gd^Fdw, Re^Fmw, Re, Re, Re^Es, Re, Re, Rb^Edb, Rb, Rb^Fdw, Rb^Fdw, Re^Ecf, Gd, Gd^Fdw, Gd, Gd
Gd, Gd, Gd, Gd, Gd, Gd^Fdw, Gs, Gd, Gd, Gd, Gd, Re^Fdw, Rb^Fdw, Re^Fdw, Re, Re^Fdw, Re^Fdw, Re, Gd, Gd, Gd, Gd
Gs, Gd, Gs, Gd, Gs^Fmw, Gs^Fmw, Gs, Gs, Gs^Es, Gd, Gd, Gd^Fdw, Gd^Fdw, Gd^Fdw, Gd^Fdw, Re, Rb, Gd, Gs, Gs, Gs, Gs
Gg, Gs, Gs^Em, Gd, Gs, Gs^Fmw, Gs^Fmw, Gs, Gs^Fmw, Gs^Fmw, Gs^Fmw, Gd, Gd, Gd, Gd, Gd, Gd, Gd, Gs^Fmw, Gs^Fmw, Gg^Fmw, Gg^Fms
Gg, Gg, Gs^Fmw, Gs^Fmw, Gs^Fmw, Gs, Gg, Gs, Gs^Fmw, Gs^Fmw, Gs^Fmw, Gd, Gd^Es, Gd^Em, Gs^Fmw, Gs^Fmw, Gs^Fmw, Rb, Gg^Fms, Gg^Fms, Gs^Fms, Gg^Fms
Gg, Gg^Efm, Gs^Fmw, Gs^Fmw, Gs^Fmw, Gg, Gg, Gs^Fmw, Gs^Fmw, Gs^Fmw, Gg, Gs, Gs^Em, Gd, Gg^Fmw, Gg^Fmw, Gg^Fmw, Rb, Gg, Gs^Fms, Gs^Fms, Gs^Fms
Gg^Efm, Gg, Gs^Fmw, Gs^Fmw, Gs^Fmw, Gs^Fmw, Gs^Fmw, Gs^Fmw, Gs^Fms, Gs^Fmw, Gg^Em, Gs, Gg, Gs^Fms, Gs^Fms, Gs^Fms, Ce, Ce, Ce, Gs^Fms, Gs^Fms, Gs^Fms
Gs^Fmw, Gs^Fmw, Gs^Fmw, Gs^Fmw, Gs^Fp, Gs^Fp, Gs^Fmw, Gs, Gs, Gg, Gs^Fp, Gg, Gs^Fp, Gs^Fms, Gs^Fms, Gs^Fms, Ce, 1 Ke, Ce, Gg^Es, Gs^Fms, Gs^Fms
Gs^Fdw, Gs^Fp, Gs^Fp, Gs^Fp, Gs^Fdw, Gs^Fp, Gs^Fdw, Gg^Efm, Gg, Gs^Fms, Gs^Fms, Gg, Gg, Gg^Efm, Gs^Fms, Gs^Fms, Gs^Fms, Ce, Gs^Fms, Gs^Fms, Gs^Fms, Gs^Fms
Gs^Fms, Gs^Fms, Gs^Fdw, Gs^Fp, Gs^Fms, Gs^Fms, Gs^Fms, Gs^Fds, Gg, Gs^Fms, Gs^Fms, Gs^Fms, Gs^Fds, Gg^Em, Gs^Fms, Gs^Fms, Gs^Fms, Gs^Fms, Gs^Fms, Gs^Fms, Gs^Fp, Gs^Fp
Gs^Fms, Gs^Fms, Gs^Fms, Gs^Fms, Gs^Fms, Gs^Fms, Gs^Fms, Gs^Fms, Gg, Gs^Fms, Gs^Fms, Gs^Fms, Gs^Fds, Gg, Gs^Fms, Gs^Fms, Gs^Fms, Gs^Fms, Gs^Fp, Gs^Fp, Gs^Fp, Gs^Fp
