Mm, Mm, Mm, Hh, Hhd, Gd, Gd, Gd, Re, Re, Gd^Fmw, Re, Re, Gd, Gs, Hh, Hh, Mm, Hh, Mm, Mm, Mm
Mm, Mm, Mm, Hh, Hhd, Gd, Gd, Gd, Re, Re, Gd^Fdw, Rb^Es, Re, Gd, Gs^Es, Hh, Hh, Mm, Hh, Mm, Mm, Mm
Mm, Mm, Hh, Hh, Hhd, Gd, Re, Re^Em, Re, Rb, Re, Re^Es, Re^Em, Gd, Gd^Es, Hhd, Hhd, Hh, Hh, Hh, Mm, Mm
Hh, Hh, Hh, Hhd, Gd, Gd, Re, Rb^Em, Re^Es, Re, Ss, Ss, Co, Re^Em, Re, Gd, Gd, Gs, Gs^Es, Hh, Mm, Mm
Hh, Hh, Hh, Gs, Gd, Re, Re^Es, Re, Re^Es, Wwg, Ss^Es, Co, 2 Ko, Co, Ss, Re^Es, Gd, Gs^Es, Hh, Hh, Hh, Hh
Mm, Mm, Hh, Gs, Gd, Re, Gd^Fdw, Rb, Re, Wwg, Wwg, Co, Co, Co, Wwg^Bw\, Re, Gs^Es, Hh, Gs, Hh, Gs, Gs
Hh, Hh, Hh, Hhd, Gd, Re, Re, Re, Re, Re^Es, Re, Wwg^Bw/, Wwg, Wwg, Re, Gs^Es, Re, Gs^Em, Re, Gs, Gs, Gs
Hhd, Hhd, Hhd, Hhd, Re, Rb, Re, Gd^Fmw, Rb^Es, Re^Es, Re, Re^Es, Rb, Rb, Re, Re^Es, Re, Re, Gd^Fdw, Re, Re, Re
Re, Re, Re, Re, Gd^Fmw, Gd^Fmw, Re, Re, Re, Re, Gd^Fdw, Re, Gd^Fmw, Re^Es, Re, Rb^Es, Re, Re^Es, Gd^Fmw, Gd^Fdw, Re, Re
Re, Re^Es, Re, Gd^Fdw, Re, Gd^Fdw, Re, Rb, Re, Gd^Fdw, Gd^Fdw, Gd^Fdw, Re, Re, Re, Gd^Fdw, Re, Gd^Fdw, Gd^Fmw, Gd^Fmw, Re, Re^Es
Re, Re, Gd^Fmw, Re, Re^Es, Re, Gd^Fmw, Re^Es, Re, Gd^Fmw, Gd^Fmw, Gd^Fmw, Re, Re^Es, Re, Re, Re, Re, Re, Re, Re, Re
Re, Re, Gd^Fmw, Re, Re, Gd^Fdw, Gd^Fdw, Gd^Fmw, Re, Re, Re^Es, Re, Gd^Fdw, Re, Re^Em, Gd^Fmw, Gd^Fmw, Re^Es, Re, Gd^Fdw, Re, Re
Re, Re, Re, Re, Re, Gd^Fdw, Gs, Gd, Gd, Re, Re, Gd^Fmw, Gd^Fdw, Gd^Fdw, Gd^Fdw, Gd^Fdw, Gd^Fdw, Re, Re, Re, Re, Re
Gs, Gd, Gs, Re, Gs^Fmw, Gs^Fmw, Gs, Gs, Gs^Es, Re, Re, Gd^Fmw, Gd^Fmw, Gd^Fmw, Gd^Fmw, Gd^Fmw, Re, Re, Gs, Gs, Gs, Gs
Gg, Gs, Gs, Re, Gs, Gs^Fmw, Gs^Fmw, Gs, Gs^Fmw, Gs^Fmw, Gs^Fmw, Re, Re, Re, Re, Re, Re, Re, Gs^Fmw, Gs^Fmw, Gs^Fmw, Gs^Fms
Gg, Gg, Gs^Fmw, Gs^Fmw, Gs^Fmw, Gs, Gg, Gs, Gs^Fmw, Gs^Fmw, Gs^Fmw, Re, Re^Es, Re, Gs^Fmw, Gs^Fmw, Gs^Fmw, Gs, Gs^Fms, Gs^Fms, Gs^Fms, Gs^Fms
Gg, Gg, Gs^Fmw, Gs^Fmw, Gs^Fmw, Gg, Gg, Gs^Fmw, Gs^Fmw, Gs^Fmw, Gg, Gs, Gs^Em, Re, Gs^Fmw, Gs^Fms, Gs^Fms, Gs, Gg, Gs^Fms, Gs^Fms, Gs^Fms
Gg, Gg, Gs^Fmw, Gs^Fmw, Gs^Fmw, Gs^Fmw, Gs^Fmw, Gs^Fmw, Gs^Fms, Gs^Fmw, Gg^Em, Gs, Gg, Gs^Fms, Gs^Fms, Gs^Fms, Gg, Gg, Cer, Gs^Fms, Gs^Fms, Gs^Fms
Gs^Fmw, Gs^Fmw, Gs^Fmw, Gs^Fmw, Gs^Fp, Gs^Fp, Gs^Fmw, Gs, Gs, Gg, Gs^Fms, Gg, Gs^Fms, Gs^Fms, Gs^Fms, Gs^Fms, Gg, Cer, 1 Ker, Cer, Gg, Gg
Gs^Fdw, Gs^Fp, Gs^Fp, Gs^Fp, Gs^Fdw, Gs^Fp, Gs^Fdw, Gg, Gg, Gs^Fms, Gs^Fms, Gg, Gg, Gg, Gs^Fms, Gs^Fms, Gs^Fms, Cer, Cer, Cer, Gs^Fms, Gs^Fms
Gs^Fms, Gs^Fms, Gs^Fdw, Gs^Fp, Gs^Fms, Gs^Fms, Gs^Fms, Gs^Fms, Gg, Gs^Fms, Gs^Fms, Gs^Fms, Gs^Fms, Gg^Em, Gs^Fms, Gs^Fms, Gs^Fms, Gg, Gg, Gs^Fms, Gs^Fms, Gs^Fms
Gs^Fms, Gs^Fms, Gs^Fms, Gs^Fms, Gs^Fms, Gs^Fms, Gs^Fms, Gs^Fms, Gg, Gs^Fms, Gs^Fms, Gs^Fms, Gs^Fms, Gg, Gs^Fms, Gs^Fms, Gs^Fms, Gg, Gg, Gs^Fms, Gs^Fms, Gs^Fms
