Gg, Gg, Hhd, Gg, Hh, Gg, Hh, Gg, Mm, Mm, Mm, Gg, Mm, Mm, Mm, Gg, Ms, Ms, Ha, Ms, Ms, Ms, Ms, Ms, Ms, Ms, Ms, Ms, Ms, Ms
Gs^Fds, Hh, Hh^Fdw, Hh, Gg^Dr, Hh, Hh^Fms, Mm, Mm, Mm, Mm, Hh, Hh, Mm, Mm, Ms, Ms, Ms, Ms, Ms, Ha, Ms, Ms, Ms, Ha, Ms, Ha, Ms, Ha, Ms
Gs^Fds, Gs^Fdw, Gs^Fdw, Hh, Gs^Fds, Gg^Dr, Hh, Mm, Hh^Fdw, Mm, Hh^Vo, Gg^Dr, Hh^Fp, Hh, Mm, Hh, Hh, Ms, Ha^Voa, Ms, Co, Ms, Ms, Ha, Mm, Ha, Mm, Ms, Mm, Ms
Gs^Fds, Gs^Fdw, Gs^Fds, Gs^Fds, Gs^Fds, Gs^Fds, Gs^Fds, Hh, Gs^Fds, Hh^Fms, Mm, Hh, Mm, Mm, Mm, Gg^Dr, Mm, Hh, Co, Co, Ko, Co, Mm, Mm, Ha, Mm, Mm, Mm, Hhd, Mm
Gs^Fds, Gs^Fds, Gs^Fds, Gs^Fds, Gs^Fds, Gs^Fdw, Gs^Fds, Gs^Fds, Gs^Fdw, Mm, Hh, Gg^Dr, Mm, Mm, Hh, Mm, Mm, Mm, Mm, Co, Co, Co, Co, Hhd, Hhd, Hhd, Hhd, Mm, Hhd^Vo, Hhd
Gg, Gs^Fds, Gs^Fds, Gs^Fds, Gs^Fds, Gs^Fds, Gs^Fds, Gs^Fds, Gs^Fds, Hh, Gg^Dr, Hh, Hh, Mm, Hh, Hh, Hh, Hh^Vo, Hh, Mm, Hh, Co, Mm, Hhd, Mm, Gg^Dr, Mm, Mm, Hhd, Hhd
Gs^Fds, Gs^Fds, Gs^Fds, Gs^Fds, Gg^Ve, Gs^Fds, Gs^Fds, Gs^Fds, Gs^Fds, Hh^Fms, Hh, Hh^Fms, Gg^Dr, Hh, Hh^Vo, Gg^Dr, Hh^Fp, Hh, Hh, Mm, Mm, Mm, Hhd, Mm, Mm, Mm, Mm, Mm, Mm, Mm
Gs^Fds, Gs^Fds, Gs^Fds, Gs^Fds, Gs^Fds, Gs^Fds, Gs^Fds, Gs^Fds, Gs^Fds, Gs^Fds, Gs^Fds, Hh, Hh, Hh, Hh, Hh, Hh, Hh, Hh, Hhd, Hhd, Hhd, Hhd, Hhd, Hhd, Hhd, Hhd, Hhd, Hhd, Hhd
Gs^Fds, Gs^Fds, Gs^Fds, Gs^Fds, Gs^Fds, Gs^Fds, Gs^Fds, Gs^Fds, Gs^Fds, Gs^Fds, Gll^Fp, Gll^Fp, Gs^Fds, Gs^Fds, Gs^Fds, Gs^Fds, Gs^Fds, Hh, Gg^Dr, Hhd, Hhd, Hhd, Hhd^Vo, Gg^Dr, Hhd, Hhd, Hhd, Hhd, Gs, Gg
Gg, Gs^Vc, Gg, Gs^Fds, Gs^Fds, Gs^Fds, Gs^Fds, Gs^Fds, Gll^Fp, Gs^Fds, Gs^Fds, Gs^Fds, Gll^Fp, Gs^Fds, Gs^Fds, Gs^Fds, Gs^Fds, Hh, Hhd, Hhd, Hhd, Hhd, Hhd, Hhd, Hhd, Hhd, Gs, Gs, Gs^Es, Gs
Gg, Gg, Gg, Gg, Gg, Gs^Fds, Gg^Em, Gs^Fds, Gll^Fp, Gll^Fp, Gs^Fds, Gs^Fds, Gs^Fds, Gll^Fp, Gs^Fds, Gs^Fds, Gll^Fp, Gs^Fds, Gs^Fds, Gs^Fds, Gs^Fds, Gs^Fds, Gs^Fds, Gs^Fds, Gs, Gs, Gs, Gs, Gd, Gd
Gg, Gg^Es, Gg, Gg, Gg, Gg, Gg, Gg, Gg^Es, Gs^Fds, Gs^Fds, Gg^Ve, Gs^Fds, Gs^Fds, Gll^Fp, Gs^Fds, Gll^Fp, Gs^Fds, Gll^Fp, Gs^Fds, Gg, Gs^Fds, Gg, Gs, Gs, Gs, Gs, Gd, Gd, Gd
Hhd, Hh, Hh, Gg, Gg, Gg^Em, Gg, Gg, Gg, Gs^Fds, Gs^Fds, Gs^Fds, Gll^Fp, Gs^Fds, Gs^Fds, Gll^Fp, Gs^Fds, Gs^Fds, Gll^Fp, Gll^Fp, Gd^Vhr, Gs^Es, Gs, Gs^Es, Gs, Gs, Gd, Gd^Vo, Gd, Gd
Hhd, Hhd, Hhd, Gg^Dr, Hh, Gg, Gg, Gg, Gg, Gg, Gs^Fds, Gs^Fds, Gll^Fp, Gll^Fp, Gs^Fds, Gll^Fp, Gs^Fds, Gll^Fp, Gg, Gg, Gs, Gs, Gs, Gs, Gd, Gd, Gd, Gd, Gll, Gd
Hh, Hh, Hhd, Hh, Hh, Gg^Dr, Gs^Vc, Gg, Gg, Gg, Gs^Fds, Gs^Fds, Gs^Fds, Gll^Fp, Gs^Fds, Gs^Fds, Gs^Fds, Gs^Fds, Gs, Gs, Gs, Gs^Efm, Gd, Gd, Gd, Gd, Gll, Gll^Em, Gll, Gll
Hhd, Hhd^Fdw, Hh, Gg^Dr, Hhd, Hh, Hh, Gg, Gg, Gg, Gg, Gg, Gg, Gs^Fds, Gg, Gg, Gg, Gs, Gs, Gs, Gd, Gd, Gd, Gd^Ecf, Gd, Gd, Co, Co, Gll, Gll
Hh^Fp, Hhd, Hhd, Hh, Gg^Dr, Hhd, Hh, Gg, Gg, Gg^Efm, Gg, Gg, Gg, Gg^Efm, Gg, Gg, Gg, Gs, Gs, Gs, Gs, Gs, Gd, Gd, Gd, Gll, Co, Ko, Co, Rb
Hh, Hhd, Hhd^Fdw, Hhd^Fp, Hhd, Hhd, Hhd, Gg^Dr, Gg, Gg, Gg, Gg, Gg, Gg, Gg^Efm, Gg, Gg, Gs^Vhr, Gg, Gs^Efm, Gs, Gs, Gs, Gd, Gd, Gll^Em, Gll, Gll, Gll^Em, Gll
Hhd, Hhd, Gg^Dr, Hhd^Fp, Hh, Hh, Hh, Gg^Dr, Hh^Fp, Gg, Gg, Gg, Gg, Gg, Gg, Gg, Gg, Gg, Gg, Gs, Gs^Wm, Gs, Gs, Gs^Efm, Gd, Gd, Gd, Gll, Gll, Gll
Hhd, Hhd^Fp, Hhd, Hh^Fp, Hh^Fdw, Hh^Fp, Hhd, Hh^Fdw, Hh^Fdw, Hh^Fp, Gg, Gg, Gg, Gg, Gg, Gg, Gg^Gvs, Gg^Gvs, Gg^Gvs, Gg^Gvs, Gg^Gvs, Gg, Gs, Gs, Gd, Gd^Vo, Gd, Gll, Gd, Gd
Hhd^Fp, Hhd^Fp, Hhd, Hhd^Fp, Gg^Dr, Hhd, Hh, Hhd^Fp, Hhd, Gg^Dr, Gg, Gg, Gg^Efm, Gg, Gg, Gs^Vh, Gg^Gvs, Gg^Gvs, Gg^Gvs, Gg^Gvs, Gg^Gvs, Gg, Gs, Gs^Efm, Gd, Gd, Gd, Gd, Gd, Gd
Hhd, Hhd^Fdw, Hhd^Fp, Hhd, Hh, Hh^Fp, Gg^Dr, Hh^Fp, Hh^Fp, Hh^Fp, Gg, Gg, Gg, Gg, Gg, Gg^Eff, Gg^Eff, Gg^Gvs, Gg^Gvs, Gg^Gvs, Gg^Eff, Gg^Eff, Gg, Gg, Gg, Gd, Gg, Gd, Gd, Gd
Hhd, Hhd, Gll^Fp, Gll^Fp, Gll^Fp, Gll^Fp, Gll^Fp, Gll^Fp, Gll^Fms, Gg^Dr, Gg, Gg, Gg^Em, Gg, Gg, Gg, Gg, Gg^Eff, Gg^Eff, Gg^Eff, Gg, Gg, Gg, Gg, Gg^Es, Gg, Gg, Gg, Gg, Gg
Gll^Fp, Gll^Fp, Gll^Fp, Gll^Fp, Gll^Fms, Gll^Fet, Gll^Fp, Gll^Fp, Gll^Fp, Gll^Fp, Gg, Gg, Gg, Gg, Gg, Gg, Gg, Gg, Gg, Gg, Gg, Gg, Gg, Gg, Gg, Gg, Gg, Gg, Gll^Fp, Gll^Fp
Gll^Fp, Gll^Fms, Gll^Fms, Gg^Ve, Gll^Fp, Gll^Fp, Gll^Fms, Gll^Fp, Gll^Fp, Gll^Fms, Gg^Es, Gg, Gg, Gg, Gs^Vh, Gg, Gg, Gg^Em, Gg, Gg, Gll^Fp, Gll^Fp, Gll^Fp, Gg, Gll^Fp, Gll^Fp, Gll^Fp, Gll^Fp, Gll^Fet, Gll^Fp
Gll^Fp, Gll^Fp, Gll^Fp, Gll^Fp, Gll^Fp, Gll^Fp, Gll^Fp, Gll^Fp, Gll^Fp, Gll^Fp, Gll^Fp, Gg, Gll^Fp, Gll^Fp, Gll^Fp, Gll^Fp, Gll^Fp, Gg, Gll^Fp, Gll^Fp, Gll^Fp, Gll^Fms, Gll^Fp, Gll^Fp, Gll^Fms, Gll^Fms, Gll^Fp, Gll^Fp, Gll^Fp, Gll^Fms
Gll^Fms, Gll^Fms, Gll^Fet, Gll^Fp, Gll^Fp, Gll^Fp, Gll^Fp, Gll^Fp, Gll^Fp, Gll^Fms, Gll^Fp, Gll^Fp, Gll^Fms, Gll^Fp, Gll^Fms, Gll^Fp, Gll^Fp, Gll^Fms, Gll^Fms, Gll^Fp, Gll^Fp, Gg^Ve, Gll^Fp, Gll^Fp, Gll^Fp, Gg^Ve, Gll^Fp, Gll^Fms, Gll^Fp, Gll^Fp
Gll^Fp, Gll^Fp, Gll^Fp, Gll^Fms, Gll^Fp, Gll^Fp, Gg^Ve, Gll^Fp, Gll^Fms, Gll^Fp, Gll^Fp, Gll^Fp, Gll^Fp, Gll^Fp, Gll^Fp, Gll^Fp, Gll^Fp, Gll^Fp, Gll^Fp, Gll^Fp, Gll^Fp, Gll^Fp, Gll^Fms, Gll^Fms, Gll^Fms, Gll^Fp, Gll^Fms, Gll^Fp, Gll^Fp, Gll^Fp
Hh, Gll^Fms, Gll^Fp, Gll^Fp, Gll^Fp, Gll^Fp, Gll^Fp, Gll^Fp, Gll^Fp, Gll^Fp, Gll^Fms, Gll^Fp, Gg^Ve, Gll^Fp, Gll^Fp, Gll^Fp, Gll^Fp, Gll^Fms, Gll^Fp, Gll^Fp, Gll^Fp, Gll^Fp, Gll^Fp, Gll^Fp, Gll^Fp, Gll^Fp, Gll^Fp, Gll^Fp, Mm, Mm
Hh, Mm, Gll^Fp, Gll^Fp, Hh, Gll^Fp, Gll^Fp, Gll^Fp, Gll^Fp, Gll^Fms, Gll^Fp, Gll^Fp, Gll^Fms, Gll^Fp, Gll^Fp, Gll^Fp, Gll^Fp, Gll^Fp, Gll^Fms, Gll^Fp, Gll^Fp, Gll^Fp, Mm, Gll^Fp, Hh, Mm, Mm, Hh, Hh^Fp, Hh
Hh, Mm, Mm, Hh, Hh, Mm, Hh^Fp, Hh, Mm, Gll^Fp, Gll^Fp, Gll^Fp, Ce, Ce, Ce, Gll^Fp, Gll^Fms, Gll^Fp, Gll^Fp, Gll^Fp, Hh^Fp, Mm, Hh, Hh, Mm, Mm, Hh^Fp, Mm, Hh^Vhh, Hh^Fp
Mm, Mm, Mm, Hh^Dr, Hh, Hh^Fp, Hh, Hh, Mm, Mm, Mm, Gll^Fp, Ce, Ke, Ce, Gll^Fp, Gll^Fp, Gll^Fp, Hh^Dr, Hh^Fp, Hh^Fp, Hh, Mm, Hh, Mm, Hh, Hh, Mm, Mm, Hh
Mm, Mm, Mm, Mm, Mm, Hh, Hh^Fp, Mm, Hh, Hh, Hh, Mm, Mm, Ce, Hh, Gll^Fp, Hh, Gll^Fp, Hh^Fp, Hh^Fp, Mm, Mm, Hh, Mm, Mm, Mm, Mm, Mm, Mm, Hh
Hh, Mm, Hh^Vhh, Hh^Dr, Hh^Dr, Mm, Mm, Hh, Mm, Hh^Dr, Hh, Hh^Fp, Hh, Mm, Mm, Hh, Mm, Hh^Fp, Mm, Mm, Hh, Hh, Hh^Fp, Hh, Hh, Mm, Mm, Mm, Hh, Mm
Mm, Mm, Mm, Mm, Mm, Mm, Mm, Mm, Hh^Dr, Hh^Fp, Hh, Hh^Fp, Hh^Fp, Mm, Hh, Hh^Fms, Mm, Hh^Dr, Hh, Hh^Dr, Mm, Mm, Mm, Hh, Mm, Mm, Mm, Mm, Mm, Mm
Gg, Mm, Mm, Mm, Gg, Mm, Mm, Mm, Hh, Mm, Mm, Hh, Hh, Mm, Hh, Mm, Hh, Hh, Hh, Mm, Gg, Mm, Hh, Hh^Fp, Mm, Mm, Mm, Mm, Mm, Mm
